  State: 0 -> ok
->new_game(easy)
  State: 1 -> ok
  +-*-+---+---+---+---+---+---+
  | X                         |
  +   +   +   +---+---+   +   +
  |       |   |       |       |
  +   +---+   +---+   +---+   +
  |   |                   |   |
  +   +   +   +   +---+   +   +
  |   |       |   |       |   |
  +   +   +---+   +   +   +   +
  |       |   |   |           |
  +---+   +   +   +---+   +---+
  |   |   |       |       |   |
  +   +   +   +   +---+   +   +
  |       |                   |
  +---+---+---+---+---+---+- -+

  Game Number: 1
  Score: 0 / 1

->abort
  State: 2 -> ok
->new_game(easy)
  State: 3 -> ok
  +-*-+---+---+---+---+---+---+
  | X                 |       |
  +   +   +   +---+---+   +   +
  |   |               |       |
  +---+   +---+   +---+   +   +
  |       |   |           |   |
  +   +   +   +---+   +---+   +
  |                   |   |   |
  +   +   +   +   +   +   +   +
  |   |   |   |               |
  +---+---+---+   +---+   +   +
  |           |   |   |   |   |
  +   +   +---+---+   +   +   +
  |               |           |
  +---+---+---+---+---+---+- -+

  Game Number: 2
  Score: 0 / 2

->abort
  State: 4 -> ok
->new_game(easy)
  State: 5 -> ok
  +-*-+---+---+---+---+---+---+
  | X                         |
  +---+---+   +---+---+   +   +
  |               |   |   |   |
  +---+---+   +---+   +   +   +
  |           |           |   |
  +   +   +---+   +---+---+   +
  |                           |
  +---+---+   +---+---+---+   +
  |       |       |   |       |
  +   +   +   +   +   +   +   +
  |       |       |   |       |
  +   +---+   +---+   +---+   +
  |       |                   |
  +---+---+---+---+---+---+- -+

  Game Number: 3
  Score: 0 / 3

->abort
  State: 6 -> ok
->new_game(easy)
  State: 7 -> ok
  +-*-+---+---+---+---+---+---+
  | X                         |
  +   +   +---+   +---+   +   +
  |       |           |   |   |
  +   +   +---+   +   +---+   +
  |       |       |   |       |
  +   +   +   +   +---+---+   +
  |   |               |       |
  +   +   +---+---+   +---+---+
  |   |                   |   |
  +   +   +   +---+   +   +   +
  |   |   |   |   |       |   |
  +   +   +   +   +---+---+   +
  |       |               |   |
  +---+---+---+---+---+---+- -+

  Game Number: 4
  Score: 0 / 4

->abort
  State: 8 -> ok
->new_game(easy)
  State: 9 -> ok
  +-*-+---+---+---+---+---+---+
  | X     |   |               |
  +---+   +   +---+   +   +   +
  |   |       |       |       |
  +   +---+   +   +   +---+---+
  |   |   |               |   |
  +   +   +   +   +   +---+   +
  |           |   |   |       |
  +   +---+   +---+---+---+   +
  |       |           |       |
  +   +---+---+   +---+   +---+
  |   |       |           |   |
  +   +   +   +   +   +   +   +
  |                           |
  +---+---+---+---+---+---+- -+

  Game Number: 5
  Score: 0 / 4

