  State: 0 -> ok
->new_game(easy)
  State: 1 -> ok
  +-*-+---+---+---+---+---+---+
  | X                         |
  +   +   +   +---+---+   +   +
  |       |   |       |       |
  +   +---+   +---+   +---+   +
  |   |                   |   |
  +   +   +   +   +---+   +   +
  |   |       |   |       |   |
  +   +   +---+   +   +   +   +
  |       |   |   |           |
  +---+   +   +   +---+   +---+
  |   |   |       |       |   |
  +   +   +   +   +---+   +   +
  |       |                   |
  +---+---+---+---+---+---+- -+

  Game Number: 1
  Score: 0 / 1

->move(E)
  State: 2 -> ok
  +-*-+---+---+---+---+---+---+
  | * * X                     |
  +   +   +   +---+---+   +   +
  |       |   |       |       |
  +   +---+   +---+   +---+   +
  |   |                   |   |
  +   +   +   +   +---+   +   +
  |   |       |   |       |   |
  +   +   +---+   +   +   +   +
  |       |   |   |           |
  +---+   +   +   +---+   +---+
  |   |   |       |       |   |
  +   +   +   +   +---+   +   +
  |       |                   |
  +---+---+---+---+---+---+- -+

  Game Number: 1
  Score: 0 / 1

->move(E)
  State: 3 -> ok
  +-*-+---+---+---+---+---+---+
  | * * * * X                 |
  +   +   +   +---+---+   +   +
  |       |   |       |       |
  +   +---+   +---+   +---+   +
  |   |                   |   |
  +   +   +   +   +---+   +   +
  |   |       |   |       |   |
  +   +   +---+   +   +   +   +
  |       |   |   |           |
  +---+   +   +   +---+   +---+
  |   |   |       |       |   |
  +   +   +   +   +---+   +   +
  |       |                   |
  +---+---+---+---+---+---+- -+

  Game Number: 1
  Score: 0 / 1

->move(E)
  State: 4 -> ok
  +-*-+---+---+---+---+---+---+
  | * * * * * * X             |
  +   +   +   +---+---+   +   +
  |       |   |       |       |
  +   +---+   +---+   +---+   +
  |   |                   |   |
  +   +   +   +   +---+   +   +
  |   |       |   |       |   |
  +   +   +---+   +   +   +   +
  |       |   |   |           |
  +---+   +   +   +---+   +---+
  |   |   |       |       |   |
  +   +   +   +   +---+   +   +
  |       |                   |
  +---+---+---+---+---+---+- -+

  Game Number: 1
  Score: 0 / 1

->move(E)
  State: 5 -> ok
  +-*-+---+---+---+---+---+---+
  | * * * * * * * * X         |
  +   +   +   +---+---+   +   +
  |       |   |       |       |
  +   +---+   +---+   +---+   +
  |   |                   |   |
  +   +   +   +   +---+   +   +
  |   |       |   |       |   |
  +   +   +---+   +   +   +   +
  |       |   |   |           |
  +---+   +   +   +---+   +---+
  |   |   |       |       |   |
  +   +   +   +   +---+   +   +
  |       |                   |
  +---+---+---+---+---+---+- -+

  Game Number: 1
  Score: 0 / 1

->move(E)
  State: 6 -> ok
  +-*-+---+---+---+---+---+---+
  | * * * * * * * * * * X     |
  +   +   +   +---+---+   +   +
  |       |   |       |       |
  +   +---+   +---+   +---+   +
  |   |                   |   |
  +   +   +   +   +---+   +   +
  |   |       |   |       |   |
  +   +   +---+   +   +   +   +
  |       |   |   |           |
  +---+   +   +   +---+   +---+
  |   |   |       |       |   |
  +   +   +   +   +---+   +   +
  |       |                   |
  +---+---+---+---+---+---+- -+

  Game Number: 1
  Score: 0 / 1

->move(E)
  State: 7 -> ok
  +-*-+---+---+---+---+---+---+
  | * * * * * * * * * * * * X |
  +   +   +   +---+---+   +   +
  |       |   |       |       |
  +   +---+   +---+   +---+   +
  |   |                   |   |
  +   +   +   +   +---+   +   +
  |   |       |   |       |   |
  +   +   +---+   +   +   +   +
  |       |   |   |           |
  +---+   +   +   +---+   +---+
  |   |   |       |       |   |
  +   +   +   +   +---+   +   +
  |       |                   |
  +---+---+---+---+---+---+- -+

  Game Number: 1
  Score: 0 / 1

->move(S)
  State: 8 -> ok
  +-*-+---+---+---+---+---+---+
  | * * * * * * * * * * * * * |
  +   +   +   +---+---+   + * +
  |       |   |       |     X |
  +   +---+   +---+   +---+   +
  |   |                   |   |
  +   +   +   +   +---+   +   +
  |   |       |   |       |   |
  +   +   +---+   +   +   +   +
  |       |   |   |           |
  +---+   +   +   +---+   +---+
  |   |   |       |       |   |
  +   +   +   +   +---+   +   +
  |       |                   |
  +---+---+---+---+---+---+- -+

  Game Number: 1
  Score: 0 / 1

->move(S)
  State: 9 -> ok
  +-*-+---+---+---+---+---+---+
  | * * * * * * * * * * * * * |
  +   +   +   +---+---+   + * +
  |       |   |       |     * |
  +   +---+   +---+   +---+ * +
  |   |                   | X |
  +   +   +   +   +---+   +   +
  |   |       |   |       |   |
  +   +   +---+   +   +   +   +
  |       |   |   |           |
  +---+   +   +   +---+   +---+
  |   |   |       |       |   |
  +   +   +   +   +---+   +   +
  |       |                   |
  +---+---+---+---+---+---+- -+

  Game Number: 1
  Score: 0 / 1

->move(S)
  State: 10 -> ok
  +-*-+---+---+---+---+---+---+
  | * * * * * * * * * * * * * |
  +   +   +   +---+---+   + * +
  |       |   |       |     * |
  +   +---+   +---+   +---+ * +
  |   |                   | * |
  +   +   +   +   +---+   + * +
  |   |       |   |       | X |
  +   +   +---+   +   +   +   +
  |       |   |   |           |
  +---+   +   +   +---+   +---+
  |   |   |       |       |   |
  +   +   +   +   +---+   +   +
  |       |                   |
  +---+---+---+---+---+---+- -+

  Game Number: 1
  Score: 0 / 1

->move(S)
  State: 11 -> ok
  +-*-+---+---+---+---+---+---+
  | * * * * * * * * * * * * * |
  +   +   +   +---+---+   + * +
  |       |   |       |     * |
  +   +---+   +---+   +---+ * +
  |   |                   | * |
  +   +   +   +   +---+   + * +
  |   |       |   |       | * |
  +   +   +---+   +   +   + * +
  |       |   |   |         X |
  +---+   +   +   +---+   +---+
  |   |   |       |       |   |
  +   +   +   +   +---+   +   +
  |       |                   |
  +---+---+---+---+---+---+- -+

  Game Number: 1
  Score: 0 / 1

->move(W)
  State: 12 -> ok
  +-*-+---+---+---+---+---+---+
  | * * * * * * * * * * * * * |
  +   +   +   +---+---+   + * +
  |       |   |       |     * |
  +   +---+   +---+   +---+ * +
  |   |                   | * |
  +   +   +   +   +---+   + * +
  |   |       |   |       | * |
  +   +   +---+   +   +   + * +
  |       |   |   |     X * * |
  +---+   +   +   +---+   +---+
  |   |   |       |       |   |
  +   +   +   +   +---+   +   +
  |       |                   |
  +---+---+---+---+---+---+- -+

  Game Number: 1
  Score: 0 / 1

->move(S)
  State: 13 -> ok
  +-*-+---+---+---+---+---+---+
  | * * * * * * * * * * * * * |
  +   +   +   +---+---+   + * +
  |       |   |       |     * |
  +   +---+   +---+   +---+ * +
  |   |                   | * |
  +   +   +   +   +---+   + * +
  |   |       |   |       | * |
  +   +   +---+   +   +   + * +
  |       |   |   |     * * * |
  +---+   +   +   +---+ * +---+
  |   |   |       |     X |   |
  +   +   +   +   +---+   +   +
  |       |                   |
  +---+---+---+---+---+---+- -+

  Game Number: 1
  Score: 0 / 1

->move(S)
  State: 14 -> ok
  +-*-+---+---+---+---+---+---+
  | * * * * * * * * * * * * * |
  +   +   +   +---+---+   + * +
  |       |   |       |     * |
  +   +---+   +---+   +---+ * +
  |   |                   | * |
  +   +   +   +   +---+   + * +
  |   |       |   |       | * |
  +   +   +---+   +   +   + * +
  |       |   |   |     * * * |
  +---+   +   +   +---+ * +---+
  |   |   |       |     * |   |
  +   +   +   +   +---+ * +   +
  |       |             X     |
  +---+---+---+---+---+---+- -+

  Game Number: 1
  Score: 0 / 1

->move(E)
  State: 15 -> ok
  +-*-+---+---+---+---+---+---+
  | * * * * * * * * * * * * * |
  +   +   +   +---+---+   + * +
  |       |   |       |     * |
  +   +---+   +---+   +---+ * +
  |   |                   | * |
  +   +   +   +   +---+   + * +
  |   |       |   |       | * |
  +   +   +---+   +   +   + * +
  |       |   |   |     * * * |
  +---+   +   +   +---+ * +---+
  |   |   |       |     * |   |
  +   +   +   +   +---+ * +   +
  |       |             * * * |
  +---+---+---+---+---+---+-X-+

  Congratulations! You escaped the maze!
  Game Number: 1
  Score: 1 / 1

->abort
  State: 16 -> Error! Not in a game.
->new_game(easy)
  State: 17 -> ok
  +-*-+---+---+---+---+---+---+
  | X                 |       |
  +   +   +   +---+---+   +   +
  |   |               |       |
  +---+   +---+   +---+   +   +
  |       |   |           |   |
  +   +   +   +---+   +---+   +
  |                   |   |   |
  +   +   +   +   +   +   +   +
  |   |   |   |               |
  +---+---+---+   +---+   +   +
  |           |   |   |   |   |
  +   +   +---+---+   +   +   +
  |               |           |
  +---+---+---+---+---+---+- -+

  Game Number: 2
  Score: 1 / 2

->abort
  State: 18 -> ok
